##################################################
#     E                               K    #  O  #
#                                          #     #
#   ######                                 #     #
#   #    #                           #######     #      
#   # *                              #           #
#   #    #                           -           #
#   ######                           |  B        #
#                                    -           #
#     Y                              #           #
############################################     #
#                                                #
#                      ###########################
#   M                  #         #
#                      !    @    #
#                      #         #
##################################
*~~~~~~*~~~~~~~*~~~~~~~*~~~~~~~*~~~~~~~*~~~~~~~*~~~~~~~*~~~~~~~*~~~~~~~*~~~~~~~*
| Hello, guy.                                                                  |
*~~~~~~*~~~~~~~*~~~~~~~*~~~~~~~*~~~~~~~*~~~~~~~*~~~~~~~*~~~~~~~*~~~~~~~*~~~~~~~*
|      |  ___  |  ___  |       |   __  |   __  |  ___  |   __  |   __  |    _  |
|   |  |   __| |   __| |  |__| |  |__  |  |__  |   _/  |  |__| |  |__| | | | | |
|   |  |  |___ |  ___| |     | |  ___| |  |__| |   /   |  |__| |   __| | | |_| |
*~~~~~~*~~~~~~~*~~~~~~~*~~~~~~~*~~~~~~~*~~~~~~~*~~~~~~~*~~~~~~~*~~~~~~~*~~~~~~~*
